20
100
BBBBBBBBBBBBBBBBBBBBBBBBBBBBBBBBBBBBBBBBBBBBBBBBBBBBBBBBBBBBBBBBBBBBBBBBBBBBBBBBBBBBBBBBBBBBBBBBBBBB
B00000000000000000000000000000000000000000000000000000000000000000000000000000000000000000000000000B
B00000000000000000000000000000000000000000000000000000000000000000000000000000000000000000000000000B
B00000000000000000000000000000000000000000000000000000000000000000000000000000000000000000000000000B
B00000000000000000000000000000000000000000000000000000000000000000000000000000000000000000000000000B
B00000000000000000000000000000000000000000000000000000000000000000000000000000000000000000000000000B
B00000000000000000000000000000000000000000000000000000000000000000000000000000000000000000000000000B
BBBBBBBBB000000000000000000BBBBBB000000000000000000000000000000000000000000000000000000000000000000B
B00000000000000000000000000000000000000000000000000000000000000000000000000000000000000000000000000B
B00000000000000000000000000000000000000000000000000000000000000000000000000000000000000000000000000B
B00000000000000000000000000000000000000000000000000000000000000000000000000000000000000000000000000B
B00000000000000000000000000000000000000000000000000000000000000000000000000000000000000000000000000B
B00000000000000000000000000000000000000000000000000000000000000000000000000000000000000000000000000B
B00000000000000000000000000000000000000000000000000000000000000000000000000000000000000000000000000B
B00000000000000000000000000000000000000000000000000000000000000000000000000000000000000000000000000B
B00000000000000000000000000000000000000000000000000000000000000000000000000000000000000000000000000B
B00000000000000000000000000000000000000000000000000000000000000000000000000000000000000000000000000B
BBBBBBBBBBBBBBBB00000000000000000000000000000000000000000000000000000000000000000000000000000000000B
BBBBBBBBBBBBBBBB00000000000000000000000000000000000000000000000000000000000000000000000000000000000B
BBBBBBBBBBBBBBBBBBBBBBBBBBBBB000000000BBBBBBBBBBBBBBBBBBBBBBBBBBBBBBBBBBBBBBBBBBBBBBBBBBBBBBBBBBBBBB